 ,_,_,_,_,_,_,_,_,_,_,_,_,_,_,_,_,_,_,_, 
|, , , , , , , ,|,*,|, , , , , , , , , ,|
|, , , , , , , ,!,$,!, , , , , , , , , ,|
|, , , , ,§, , , , , , , ,§, , , , , , ,|
|, , , , ,§, , , , , , , ,§, , , , , , ,|
|, , , , ,§, , , , , , , ,§, , , , , , ,|
|, , , , ,§, , , , , , , ,§, , , , , , ,|
|, , , , ,§, , , , , , , ,§, , , , , , ,|
|, , , , , , , , , , , , , , , , , , , ,|
|, , , , , , , , , , , , , , , , , , , ,|
|,_,_,_,_,_,_,_,_,I,_,_,_,_,_,_,_,_,_,_,|